50
50
a a a a a a a a a a a a a a a a a a a a a a a a a a a a a a a a a a a a a a a a a a a a a a a a a a 
a b b b b b b b b b b b b b b b b b b b b b b b b a b b b b b b b b b b b b b b b b b b b b b b b a
a w w w a a a a a a a a a a a a a w a a a a a w w a w w w w w w w w w w w w w w w w w w w w w w b a
a w w w a a a a a a a a a a a a a w a a a a a w w a w w w w w w w w w w w w w w w w w w w w w w b a
a w w w a a a a a a a a a a a a a w a a a a a w w a w w w w w w w w w w w w w w w w w w w w w w b a
a w w w w w w a a w w w a a a a a w a a a a a w w a w w w w w w w w w w w w w w w w w w w w w w b a
a w w w w a a a a a a a a a a a a w a a a a a w w a w w w w w w w w w w w w w w w w w w w w w w b a
a w w w a a a a a a a a a a a a a w a a a a a w w a w w w w w w w w w w w w w w w w w w w w w w b a
a w w w a a a a a w a a a w a a a w a a a a a w w a w w w w w w w w w w w w w w w w w w w w w w b a
a w w w w w w a a a a a a a a a a w a a a a a w w a w w w w w w w w w w w w w w w w w w w w w w b a
a w w w a a a a a a a a a a a a a w a a a a a w w a w w w w w w w w w w w w w w w w w w w w w w b a
a w w a a a a w a a a a a a a a a w a a a a a w w a w w w w w w w w w w w w w w w w w w w w w w b a
a w w a a a a a a w a a a a a a a w a a a a a w w a w w w w w w w w w w w w w w w w w w w w w w b a
a w w w w w w w w w w w w w w w w w a a a a a w w a w w w w w w w w w w w w w w w w w w w w w w b a  
a w w w w w w w w w w w w w w w w w a a a a a w w a w w w w w w w w w w w w w w w w w w w w w w b a
a w w w w w w w w a w w w w w w w w a a a a a a w a w w w w w w w w w w w w w w w w w w w w w w b a
a w w a a a a a a a a a a a a a a a a a a a a a w a w w w w w w w w w w w w w w w w w w w w w w b a
a w w a a a a a a a a a a a a a a a a a a a a a w a w w w w w w w w w w w w w w w w w w w w w w b a
a w w a a a a a a a a a a a a a a a a a a a a a w a w w w w w w w w w w w w w w w w w w w w w w b a
a w w a a a a a a a a a a a a a a a a a a a a a w a w w w w w w w w w w w w w w w w w w w w w w b a
a w a a a a a a a a a a a a a a a a a a a a a a w a w w w w w w w w w w w w w w w w w w w w w w b a
a w a a a a a a a a a a a a a a a a a a a a a a w a w w w w w w w w w w w w w w w w w w w w w w b a
a w a a a a a a a a a a a a a a a a a a a a a a w a w w w w w w w w w w w w w w w w w w w w w w b a
a w a a a a a a a a a a a a a a a a a a a a a a w a w w w w w w w w w w w w w w w w w w w w w w b a
a w a a a a a a a a a a a a a a a a a a a a a a w a w w w w w w w w w w w w w w w w w w w w w w b a
a w a a a a a a a a a a a a a a a a a a a a a a w a w w w w w w w w w w w w w w w w w w w w w w b a
a w a a a a a a a a a a a a a a a a a a a a a a w a w w w w w w w w w w w w w w w w w w w w w w b a
a w a a a a a a a a a a a a a a a a a a a a a a w a w w w w w w w w w w w w w w w w w w w w w w b a
a w a a a a a a a a a a a a a a a a a a a a a a w a w w w w w w w w w w w w w w w w w w w w w w b a
a w a a a a a a a a a a a a a a a a a a a a a a w a w w w w w w w w w w w w w w w w w w w w w w b a
a w a a a a a a a a a a a a a a a a a a a a a a w a w w w w w w w w w w w w w w w w w w w w w w b a
a w a a a a a a a a a a a a a a a a a a a a a a w a w w w w w w w w w w w w w w w w w w w w w w b a
a w a a a a a a a a a a a a a a a a a a a a a a w a w w w w w w w w w w w w w w w w w w w w w w b a
a w a a a a a a a a a a a a a a a a a a a a a a w a w w w w w w w w w w w w w w w w w w w w w w b a
a w a a a a a a a a a a a a a a a a a a a a a a w a w w w w w w w w w w w w w w w w w w w w w w b a
a w a a a a a a a a a a a a a a a a a a a a a a w a w w w w w w w w w w w w w w w w w w w w w w b a
a w a a a a a a a a a a a a a a a a a a a a a a w a w w w w w w w w w w w w w w w w w w w w w w b a
a w a a a a a a a a a a a a a a a a a a a a a a w a w w w w w w w w w w w w w w w w w w w w w w b a
a w a a a a a a a a a a a a a a a a a a a a a a w a w w w w w w w w w w w w w w w w w w w w w w b a
a w a a a a a a a a a a a a a a a a a a a a a a w a w w w w w w w w w w w w w w w w w w w w w w b a
a w a a a a a a a a a a a a a a a a a a a a a a w a w w w w w w w w w w w w w w w w w w w w w w b a
a w a a a a a a a a a a a a a a a a a a a a a a w a w w w w w w w w w w w w w w w w w w w w w w b a
a w a a a a a a a a a a a a a a a a a a a a a a w a w w w w w w w w w w w w w w w w w w w w w w b a
a w a a a a a a a a a a a a a a a a a a a a a a w a w w w w w w w w w w w w w w w w w w w w w w b a
a w a a a a a a a a a a a a a a a a a a a a a a w a w w w w w w w w w w w w w w w w w w w w w w b a
a w a a a a a a a a a a a a a a a a a a a a a a w a w w w w w w w w w w w w w w w w w w w w w w b a
a w a a a a a a a a a a a a a a a a a a a a a a w a w w w w w w w w w w w w w w w w w w w w w w b a
a w a a a a a a a a a a a a a a a a a a a a a a w a w w w w w w w w w w w w w w w w w w w w w w b a
a w b b b b b b b b b b b b b b b b b b b b b b b b b b b b b b b b b b b b b b b b b b b b b b b a
a a a a a a a a a a a a a a a a a a a a a a a a a a a a a a a a a a a a a a a a a a a a a a a a a a